SO ./assets/textures/walls/33-50/Asset18.png
NO ./assets/textures/walls/33-50/Asset14.png
WE ./assets/textures/TormentTextures/TrueColour/str_stoneflr6.png
EA ./assets/textures/TormentTextures/TrueColour/str_metalpan3.png

C 130,0,130
F 190,128,60


               111111111111111111
           11111000000000000000001111
    111111100000000000010000000000000111111
   1100000X100000010000001000010000000X001I1
  10000110010000000001000000000001000000010011
 11000100010000010000000000100X0000000000010X01
11000100I10H000000010001000001001000010000100001
100001X000000010000000001000100000000100001000001
 1001111111111111111111X0I0100000000100000000001
 101                   111111111111111111111001
 101                                    1110001
 101                                      10001
 1N1                                      1001
  1                                      10001
 1I1                                      1001
10001                                     10001
10X01                                      1001
10001                                      10001
10001                                       1001
10001                                      10001
10001                                       1001
10001                                    1110X01
10001                                 111000001
100011                          11111100000001
10000111111111111111111111111111X0H01000H0001
1000000000000000000000000000000000I100000001
110000000000000H000000010000001111100000001
 11000000000000000000001X00000000000000111
  1111111111111111111111111111111111111