SO ./assets/textures/walls/33-50/Asset18.png
NO ./assets/textures/walls/33-50/Asset14.png
WE ./assets/textures/TormentTextures/TrueColour/str_stoneflr6.png
EA ./assets/textures/TormentTextures/TrueColour/str_metalpan3.png

C 130,0,130
F 190,128,60


                11111111
           1111100000X00111
    111111100100010000100001111
   1100000X10001000010001000X00111
  1000011000010000100000001000100011
 110001000100000100001000X0010X000001
11000100I10H000000010001000000001001
100001X0000000100000010001001000001
 1001111111111111111111X0I01001011
 101                   111111001
 101                     1110001
 101                       10001
 1N1                       1001
  1                       10001
                           1001
                           10001
                            1001
                            10001
                             1001
                            10001
                             1001
                           110X01
                          1000001
                         100011111
                   11111100111X0H01
                  1000000000000000I1
                 100001111111111111
                10I00001
                 111111