NO ./assets/textures/TormentTextures/TrueColour/str_metalpan3.png

SO ./assets/textures/walls/17-32/Asset6.png

WE ./assets/textures/walls/17-32/Asset15.png

EA ./assets/textures/walls/17-32/Asset11.png


C 35,10,80

F 20,20,20

 111111111111111111111111111111111111111
10000000000000000000000000000000000000001
10100000000000000000000000011111111110001
101000000000010000000H000001        10001
1010000000000100010001000101        10X01
1010000000000101000100010001        10001
1010000000000000010001000101        10001
1010000000000000000000000001        10001
10100000000000000000000000011111111110001
1N100000000000010I00000000000000000000001
1100000000H000010X00000000000000000000001111111
100000000000100100000000000000000000000000000001
10000000000010000000000000000000000000000000000111
100000000000111111111111111111111111100010000000001
1000000000000000000000001           10001110000001
1000000000000000000000001           10001  100001
1000000000000000000000001           10001  10001
1000000000000000000000001           10001   101
1000000000000000000000001           10001   101
1000000000000000000000001           10001   10011111
100000000000000111111111            10001   10000000111111  
1000000000000001                    10001   1000000000000X1
1000000000000001                    10001    111110000H0001
1000000000000001                    10001         100000I1
1000000000000001                    10001          111111
1000000000000001                    10001
1000000000000001                    10001
1000000000000001                    10001
1000000000000001                    10001
1000000000000001                    10001
1000000000000001                    10001
1000000000000001                    10001
1000000000000001                    10001
1000000000000001                    10001
1000000000000001                    10001
1000000000000001                    10001    11
1000000000000001                    100001111001
1000000000000001                    10000000H0I01
1000000000000001                    100001111001
1000000000000001                    10001    11
1000000000000001                    10001
1000000000000001                    10001
1000000000000001                    10001
1000000000000001                    10001
1000000000000001                    10001
10H0000000000001                    10001
1000X00000000001                    10001
10I0000000000001                    10001
1111111111000001                    10001
1000000000000001                    10001
1000000000000001                    10001
1000000000000001                    10001
1000000000000001                    10001
1000000000000001                    10001
1000000000000001                    10001
1000000000000001                    10001
1000000000000001                    10001
1000000000000001                    10001
1000000000000001                    10001
1000000000000001                    10001
1000000000000001                    10001
1000000000000001                    10001
1000000000000001                    10001
1000000000000001                    10001
1000000000000001                    10001
1000000000000001                    10001
1000000000000001                    10001
1000000000000001                    10001
1000000000000001                    10001
1000000000000001                    10001
1000000000000001                    10001
1000000000000001                    10001
1000000000000001                    10001
1000000000000001                    10001
1000000000000001                    10001
1000000000000001                    10001
1000000000000001                    10001
1000000000000001                    10001
1000000000000001                    10001
1000000000000001                    10001
1000000000000001                    10001
1000000000000001                    10001
1000000000000001                    10001
1000000000000001                    10001
1000000000000001                    10001
1000000000000001                    10001
1000000000000001                    10001
1000000000000001                    10001
1000000000000001                    10001
1000000000000001                    10001
1000000000000001                    10001
1000000000000001                    10001
1000000000000001                    10001
1000000000000001                    10001
1000000000000001                    10001
1000000000000001                    10001
1000000000000001                    10001
1000000000000001                    10001
1000000000000001                    10001
1000000000000001                    10001
1000000000000001                    10001
1000000000000001                    10001
1000000000000001                    10001
1000000000000001                    10001
1000000000000001                    10001
1000000000000001                    10001
1000000000000001                    10001
1000000000000001                    10001
1000000000000001                    10001
1000000000000001                    10001
1000000000000001                    10001
1000000000000001                    10001
1000000000000001                    10001
1000000000000001                    10001
1000000000000001                    10001
1000000000000001                    10001
1000000000000001                    10001
1000000000000001                    10001
1000000000000001                    10001
1000000000000001                    10001
1000000000000001                    10001
1000000000000001                    10001
1000000000X00001                    10001
1000000000000001                    10001
1000000000000001                    10001
1000000000000001                    10001
1000000000000001                    10001
1000000000000001                    10001
1000000000000001                    10001
1000000000000001                    10001
1000000000000001                    10001
1000000000000001                    10X01
 11111111111111                      111
