1111111111111
1100001000011
1000000000001
100000S000001
1000000000001
1100001000011
1000000000001
1000000000001
1000000000001
1100001000011
1111111111111