NO ./assets/textures/TormentTextures/TrueColour/str_metalgen4.png

SO ./assets/textures/walls/17-32/Asset6.png

WE ./assets/textures/walls/1-16/Asset6.png

EA ./assets/textures/walls/17-32/Asset2.png


C 54,0,60

F 30,30,13

1111111111111111111111111111
1000000000000000000000000001
10000000000000001000X0000001
1111111111111100111111111111
10000000X000010000000H000001
1001111111100100010001000101
10000000000001010X010X010X01
1111100001111100010001000101
1000X0000X000100000000000001
1001110011100111111111111001
1000H000000000010I0000000001
10000000111010010X0000X00001
1000000010001001000000000001
1000000000001000000000000001
1000000111111111111111111111
100X000000000000000000I00001
1000000000000000000000000001
1000111100010001000100010001
10001I0100010001000100010001
100000X10X010I01000100010N01
1111111111111111111111111111

