NO ./assets/textures/walls/1-16/Asset3.png

SO ./assets/textures/walls/17-32/Asset2.png

WE ./assets/textures/walls/1-16/Asset6.png

EA ./assets/textures/walls/17-32/Asset2.png
F 220,100,0 
C 225,30,0 

            1111111111111111111111111111
            1000000000001000000000000101
            1011111000000011111111100101111
111111111111010100000100000100000000000000001
1010111010010111100101011100000000000000001
1010000010000000000101000000000000000000001
1010111110000011111001000101111111111111111
1000001000000000000001000101
1000001000000000000001000101
1000000000100000000000000101
1000100000000000000111110101
1000100000000000000100000101
 1110100000000000000111100101
1000100000000000000000010101
1000000000000000000000000101
1010000000000100000100010101
1010000000000000000101110101
1010100000000101000100000101
1010101111111111000111111101
1010101000000001000000000001
1010101111011111000111111111
1000101 100001 1000000000001
1111111 111111 1111111111111
					
