NO ./assets/textures/walls/1-16/Asset3.png

SO ./assets/textures/walls/17-32/Asset2.png

WE ./assets/textures/walls/1-16/Asset6.png

EA ./assets/textures/walls/17-32/Asset2.png

C 100,80,130

F 60,50,55

1111111111111111111111111111
10000000S0001000000000000101
1011111000000011111111100101
100000000H010100000100000101
1010111010010111100101011101
1010000010000000000101000001
1010111110000011111001000101
1000010000000000000001000101
1000001000000H00000001000101
100000000010000X000000000101
1000100000000000000111110101
10001000X0000000000100000101
1110100000000000000111100101
10001000000X0000X00000010101
10000X0000000000000000000101
1010000X00000100000100010101
1010000000000000000101110101
1010100000000101000100000101
1010101111111111000111111101
10101010000000010000000000X1
1010101111111111000111111111
1X00101000010000000000000001
1111111111111111111111111111

