NO ./textures/air.png

EA ./textures/water.png

SO ./textures/earth.png

WE ./textures/fire.png

   C 60,30,60

F      60,50,55

1111111111111111111111111111
1000000000001000000000000101
1011111000000011111111100101
1000000000010100000100000101
1010111010010111100101011101
1010000010000000000101000001
1010111110000011111001000101
1000001000000000000001000101
1000001000000000000001000101
1000000000100000000000000101
1000100000000000000111110101
1000100000000000000100000101
1110100000000000000111100101
1000100000000000000000010101
1000000000000000000000000101
1010000000000100000100010101
1010000000000000000101110101
1010100000000101000100000101
1010101111111111000111111101
1010101000000001000000000001
1010101111111111000111111111
1000101000010000000000000001
1111111111111111111111111111

