NO ./assets/textures/walls/1-16/Asset3.png

SO ./assets/textures/walls/17-32/Asset2.png

WE ./assets/textures/walls/1-16/Asset6.png

EA ./assets/textures/walls/17-32/Asset2.png
F 220,100,0 
C 225,30,0 

            1111111111111111111111111111
            1000000000001000000000000101
            10111110000000111111111001011111
111111111111010100000100000100000000000000001                  
10101110100101111001010111000000000000000011
1010000010000000000101000000000000000000001
101011111000001111100100010111111111111111
1000001000000000000001000101
1000001000000000000001000101
1000000000100000000000000101
1000100000000000000111110101
1000100000000000000100000101
 1110100000111000000111100101
100010000001 100000000010101
10000000000111000000000001011
1010000000000100000100010101
10100000000000000001011101011
1010100000000101000100000101
1010101111111111000111111101
1010101000000001000000000001
1010101111011111000111111111
1000101 100001 1000000000001
1111111 111111 111111111111
					
