NO ./assets/textures/walls/1-16/Asset3.png

SO ./assets/textures/walls/17-32/Asset2.png

WE ./assets/textures/walls/1-16/Asset6.png

EA ./assets/textures/walls/17-32/Asset2.png

C 100,80,130

F 60,50,55

1111111111111111111111111111
1000W00000001000000000000101
1011111000000011111111100101
1000000000010100000100000101
1010111010010111100101011101
1010000010000000000101000001
1010111110000011111001000101
1000001000000000000001000101
1000001000000000000001000101
1000000000100000000000000101
1000100000000000000111110101
1000100000000000000100000101
11101000000000000X0111100101
100010000H000000000000010101
1000000000000X00000000000101
101000X000000100000100010101
1010000000000000000101110101
1010100000000101000100000101
1010101111111111000111111101
1010101000000001000000000001
1010101111111111000111111111
1000101000010000000000000001
1111111111111111111111111111

