NO ./assets/textures/walls/1-16/Asset3.png


WE ./assets/textures/walls/1-16/Asset6.png

EA ./assets/textures/walls/17-32/Asset2.png
F 220,100,0 
C 225,30,0 

111111
1S0001
1000I1
111111
