NO ./assets/windows_maze/wall.png

SO ./assets/windows_maze/wall.png a

WE ./assets/windows_maze/wall.png

EA ./assets/windows_maze/wall.png


C 200,200,200

F 130,100,0

111111111
1S1000101
101010101
101010101
100010001
111111111