NO ./assets/textures/TormentTextures/TrueColour/str_metalgen4.png

SO ./assets/textures/walls/17-32/Asset6.png

WE ./assets/textures/walls/1-16/Asset6.png

EA ./assets/textures/walls/17-32/Asset2.png

EH ./assets/enemies/wizard_strucky.png
ES ./assets/enemies/wizard_attack3.png
EI ./assets/enemies/wizard_idle.png

IT ./assets/items/key.png
HE ./assets/items/red_potion.png


C 35,10,80

F 20,20,20
C 35,10,80

 111111111111111111111111111111111111111
100000000000000000000000000000001I000001
1000000000000000000000000000001X000X10001
11111111111111111111111111111111111110H01
100000I00000010000000H000001        10001
100X00000X000100010001000101        10X01
10000000000001010X010X010X01        10001
1000000000000000010001000101        10001
1000000000000000000000000001        10001
10000000011111111111111111111111111110001
10000000000000010I00000000000000000000001
1000000000H000010X00000000000000000000001111111
100000000000100100000000000000000000000000000001
100000000000100000000000000000000000000000000001111
100000000000111111111111111111111111111110000000001111
1000000000000001                         11100000000111111
1000000000000001                            1000000000000X1
10000000000000W1                             111110000H0001
1000000000000001                                  100000I1
1000000000000001                                   111111
 11111111111111
