SO ./assets/textures/walls/33-50/Asset4.png
NO ./assets/textures/walls/33-50/Asset14.png
WE ./assets/textures/walls/1-16/Asset15.png
EA ./assets/textures/walls/17-32/Asset4.png

EH ./assets/enemies/wizard_strucky.png
ES ./assets/enemies/wizard_attack3.png
EI ./assets/enemies/wizard_idle.png

IT ./assets/items/key.png
HE ./assets/items/red_potion.png

C 130,0,50
F 40,10,40


1111111111111111111
1E00000000000000001
1111100000000000001
1000000000000000001
1000000000000000001
1000000000000000011
1000000000000000001
1000000000000000001
1000000000000000001
1000000000000000001
1000000000000000001
1000000000000000001
1000000111100000001
1000000000000000001
1000000000000000001
1000000000000000001
1000000000000000001
1110000000000000001
1000000000000000001
1000000000000000001
1000000000000000001
1000000000000000001
1000000000000000001
1000000000000000001
1000000000000000001
100X000000000000001
1000000000000000001
1000000000000000001
1000000000000000001
1000000000000000001
1000000000000000001
1000000000000000001
1000000000000000001
1000000000000000001
1000100000000000001
1000000000000000001
1000000000000000001
1000000000000000001
1000000000001000001
1000000000000000001
1000000000000000001
100000X000000000001
1000000000000000001
1000000000000000001
1000000000000000001
1000000000000000001
1000000000001000001
1000000000000000001
1000000000000000001
1000000000000000001
1000000000000000001
1000000000000000001
1000000000000000001
1000000000000000001
1000000000000000001
1000000000000000001
1000000000000000001
1000000000000000001
1000000000000000001
1000000000000000001
1000000000000000001
1000000000000000001
1000000000011111001
1000000000000000001
1000000000000000001
1000000000000000001
1000000000000000001
1000000000001000001
1000000000000000001
1000000000000000001
1000000000000000001
1000000000000000001
1000000000000000001
1000000000000000001
1000000000000000001
1000000000000000001
1000000000000000001
1000000000000000001
1000000000000000001
1111111111111111111